1111111111111111111111111111111111
10E000000000000C00000C000000000001
1010010100100000101001000000010101
1010010010101010001001000000010101
100000000000000C00000C0000000000P1
1111111111111111111111111111111111